11110011111111001111
10000000011000000001
10000000011010110101
10000000011000000001
00000000000011001100
00000000000011001100
10000000011000000001
10000000011010110101
10000000011000000001
11110011111111001111
11110011111111001111
10111111011000000001
10000001011000000001
11111001011110000111
00000000000000000000
00000000000000000000
10101111111110000111
10100000011000000001
10111111011000000001
11110011111111001111
